AACGCCAAC	AZLY
TGAAGCCAAC	AZLG
ATCGGACCAAC	YELL
CTGATACCAAC	AZYG
TGAGAGAAC	CAGL
GGTAGGAAC	YEGL
GGCCATAAC	ORYO
CATACTAAC	YEYR
CCAGAACCAAC	CADG
AGACGCAAC	YELR
TAGATCAAC	AZYO
AATAAGCAAC	ORDG
TCGGAGCAAC	CAYG
CCAACGCAAC	ORRO
ATCGCGCAAC	AZRD
CCTTATCAAC	CARY
CGGTCCAAC	SDGL
AACCGCCAAC	ORYD
CTGATCCAAC	SDRD
ACCAAGCCAAC	YEGK
TAGGAGCCAAC	AZRK
GATACGCCAAC	YEGR
TTAACTCCAAC	ORGL
TGCGAAGCAAC	SDDD
AGGTACCAAC	AZLL
TCGCGACCAAC	CAGR
CATTGACCAAC	YEDG
CAGCAGAAC	CADR
GTCTCGAAC	ORRD
CCATGGAAC	AZDG
ATGGATAAC	AZYD
TTACCTAAC	ORGY
AGGTAACCAAC	CAGG
TCTGGCAAC	ORKR
GTTCTCAAC	AZYR
CGCCAGCAAC	CARL
GTATAGCAAC	YERY
GAGCCGCAAC	CADD
TACTTGCAAC	SDDY
GGTACTCAAC	AZRY
CTCAGCAAC	ORRG
GTTGGCCAAC	AZDD
TCTCTCCAAC	ORYG
CGTCAGCCAAC	YEDL
GTATAGCCAAC	AZRL
TCTTATCCAAC	SDRG
GCCGCTCCAAC	YEYG
TAACCAGCAAC	CAYY
GAAGGTAAC	AZKY
GCAGTTCAAC	SDGG
GGTCCATCAAC	AZYY
TTACGCTCAAC	SDLL
GTACGGCAC	YEYD
GCATATCAC	CALY
AGCAGTCAC	AZBG
GCGCAAGAC	YEBR
TTACCTCAAC	ORKL
AGCCTGGCAAC	CARD
CGCCTCCAC	183387
ACGCCGCAC	AZGK
CGCTGAGAAC	CALL
TAGAACGAAC	ORDL
GGCGCCGAAC	SDYR
TTATTCGAAC	ORKO
CTTGCAGCAAC	AZGL
AATTACCAC	YERR
AGGCCAGAAC	ORLR
GCATCAGAAC	YEWG
CCGTCAAGAAC	AZDL
CTCCGAAGAAC	SDDG
TTGGTAAGAAC	YEKY
TCCTCTTGAAC	SDYY
ACGAGTCAAC	CADY
GGTAATGCAAC	SDRR
TCCATATCAAC	CALD
GATGCGCAC	SDYL
CTTCATCAC	YERD
TCCGCTCAC	AZDY
GAGCTTCAC	CAYL
GGAATGGAAC	YEGG
AGAACCGCAAC	AZYL
ATAATCCAC	YELY
CGAACGCAC	AZGG
ATAAGAGAAC	YERK
TCCATAGAAC	ORBD
ACTGACGAAC	YEYY
CCGCGCGAAC	SDLD
TCTCGCATAAC	AZGR
GTCGACCAC	YEDY
TGAGAAGAAC	CARR
CATGCAGAAC	SDRL
GACGCAAGAAC	CAYD
TCAAGAAGAAC	YEDD
GGTTGAAGAAC	SDGY
TGGACCAGAAC	AZRR
AGCTAAGAC	ORBY
