AZBG	dorsalis
AZDD	dorsalis
AZDG	dorsalis
AZDL	dorsalis
AZDY	dorsalis
AZGG	dorsalis
AZGL	dorsalis
AZGR	dorsalis
AZKY	dorsalis
AZLG	dorsalis
AZLL	dorsalis
AZLY	dorsalis
AZRD	dorsalis
AZRK	dorsalis
AZRL	dorsalis
AZRR	dorsalis
AZRY	dorsalis
AZYD	dorsalis
AZYG	dorsalis
AZYL	dorsalis
AZYO	dorsalis
AZYR	dorsalis
AZYY	dorsalis
CADD	thurberi
CADG	thurberi
CADR	thurberi
CADY	thurberi
CAGG	thurberi
CAGL	thurberi
CAGR	thurberi
CALL	thurberi
CARD	thurberi
CARL	thurberi
CARR	thurberi
CARY	thurberi
CAYD	thurberi
CAYG	thurberi
CAYY	thurberi
ORBY	shufeldti
ORDG	shufeldti
ORDL	shufeldti
ORGL	shufeldti
ORGY	shufeldti
ORKL	shufeldti
ORKO	shufeldti
ORKR	shufeldti
ORLR	shufeldti
ORRD	shufeldti
ORRG	shufeldti
ORRO	shufeldti
ORYD	shufeldti
ORYG	shufeldti
ORYO	shufeldti
SDDD	aikeni
SDDG	aikeni
SDDY	aikeni
SDGG	aikeni
SDGL	aikeni
SDGY	aikeni
SDLD	aikeni
SDLL	aikeni
SDRD	aikeni
SDRG	aikeni
SDRL	aikeni
SDRR	aikeni
SDYL	aikeni
SDYR	aikeni
SDYY	aikeni
YEBR	phaeonotus
YEDD	phaeonotus
YEDG	phaeonotus
YEDL	phaeonotus
YEDY	phaeonotus
YEGK	phaeonotus
YEGL	phaeonotus
YEGR	phaeonotus
YEKY	phaeonotus
YELL	phaeonotus
YELR	phaeonotus
YELY	phaeonotus
YERD	phaeonotus
YERK	phaeonotus
YERR	phaeonotus
YERY	phaeonotus
YEWG	phaeonotus
YEYD	phaeonotus
YEYG	phaeonotus
YEYR	phaeonotus
YEYY	phaeonotus